###      #####           ####
#   ##########   ######   # #
# ####                # # # #
# ##########          # # # #
#                     # # # #
# # ## ### ## ######### # # #
# #    #   ##B#         # # #
# # ## ################ # # #
### ##             #### # # #
### ############## ## # # # #
###             ##    # # # #
###### ######## ####### # # #
###### ####             #   #
A      ########     #########
